11 11
2 2 1 1 1 1 1 1 2 2 2
2 1 1 1 1 1 1 1 1 2 2
1 1 1 1 1 1 1 1 1 1 2
1 1 1 1 1 1 1 1 1 1 1
1 1 1 1 1 1 1 1 1 1 1
1 1 1 1 1 1 1 1 1 1 1
1 1 1 1 1 1 1 1 1 1 1
6 1 1 1 1 1 1 5 1 1 1
2 6 1 1 1 1 1 1 1 1 2
2 2 6 1 1 1 1 1 1 2 2
2 2 2 1 1 1 1 1 2 2 2