11 11
6 1 1 1 1 1 2 1 1 1 5
2 6 1 1 1 1 1 2 1 1 1
1 2 6 1 1 1 1 1 2 1 1
1 1 2 6 1 1 1 1 1 2 1
1 1 1 2 1 1 1 1 1 1 1
1 1 1 1 1 1 1 1 1 1 1
1 1 1 1 1 1 1 1 1 1 1
2 1 1 1 1 1 1 1 2 1 1
1 2 1 1 1 1 1 2 1 1 1
1 1 2 1 1 1 2 1 1 1 1
1 1 1 2 1 2 1 1 1 1 1