11 11
2 2 2 2 2 2 1 1 1 2 2
2 1 1 1 1 1 1 1 1 1 2
2 1 1 1 1 1 1 1 1 1 2
1 1 1 1 1 1 1 1 1 1 2
1 1 1 1 1 1 1 1 1 1 2
1 1 1 1 1 1 1 2 1 6 2
1 1 1 1 1 1 1 1 2 2 2
1 5 1 1 1 1 1 1 1 1 2
1 1 1 1 1 1 1 1 1 1 2
2 1 2 2 2 2 2 2 1 1 2
2 2 2 1 1 1 1 2 2 2 2